C    9,20,60
F    9,  15,   0 
EA ./Bonus/walls/1.png
NO ./Bonus/walls/2.png
SO ./Bonus/walls/3.png
WE ./Bonus/walls/4.png


11111111111111                                              111111111111111   
10010000000001111111111111111111111                         110000000000001    
10000000000000000000000000000000001                         100000000000001        
10000000000000000000000000000000001                        1100000000111111
100000000aaaa0000000000000000000001                        110000000111111111111
10000010000000000000000000000000001                       1100000000000000000001
100000000000000000cccccc00000000001111111111              1100000000000001111111
1000000000000000000000000000000000d000000001              11001111111100001111111
10000000010000000000000000000000001110111111             11000011   1110001111111
10000000000000000000000000000000001 101                   1000011   111000111111
100000000000000000E0000000000000001 101                   1100011     100011
10000000000000000000000000000000001 101                    10001      10001
10000000000000000000000000000000001 101111111111111111111111011111111110001
10000000000000000000000000000000001 100000000000000000000000000000000000011
10000010000000000000000000000000001 11111111111011111111100011101111111111
10000000000000000000000000000000001111111111111011111111110011101111
10000000000000000000000000000000001111111111111001111111110111101111111111111
11111111000000111100000001111111111110000000000001111111110000000000000000001
111111111d1111111111111d111111111111101111111111011111111111100000111111111d1
        100111  100000000000001     1011111111110000000000000011111       101
        101111111d1111111011111     101 111111111111111111111111111       101
        10000000000001  10111111111110111000000000001                     101
        11111111111001  10000000000000000011111111101                     101
111111111111111111111111111111111111111111111111111d1                     101
                                                  1011111111111111111111111d1
                                                  100000000000000000000000001
                                                  111111111111111111111111111 