C    9,20,60
F    9,  0,   0 
EA ./Bonus/walls/1.png
NO ./Bonus/walls/2.png
SO ./Bonus/walls/3.png
WE ./Bonus/walls/4.png


1111111111111111111111111111111111111111111111111111
10010000000000000000000000000000000000000000000aaN1
10dc000000000a000000d0oo0000000000000d000000aaa1a1
10000000000000000000000000000000d0000d000000000d01
100000d100000000000000000000000000000d000000000101
1000000000000000000000000000000000000d00000000000d1
1000000000000000000000d00000000000000d000000000001
10000000000c00000000000000000000000000000000000001
10000000000000000000000000000000000000000000000001
10000000000000000000000000000000000000000000000001
1000000000000000000001b0000000000b0000000000000001
1000000000000000000000000000000000000000000c000001
10000000000000000000000000000000000000000000000001
100000000000000a0000000000000000000000000000000001
10000000000000000000000000000000000000000000000001
10000000000000000000000000000000000000000000000001
10000000000000000000000000000000b000000000000000001
100000000000000000000000000000000000000000000000001
100000100000000000000000000000000000000000000000001
1111111111111111111111111111111111111111111111111111