C    9,20,60
F    9,  0,   0 
EA ./Mandatory/1.png
NO ./Mandatory/2.png
SO ./Mandatory/3.png
WE ./Mandatory/4.png
1111111111111
100100000000E1
1000000000001
1000001000001
1000000001001
1000000000001
1000001000001
1111111111111